*****************
*   +           *
*+         +    *
*           @   *
*              +*
*               *
*+       +      *
*   #           *
*               *
*       +       *
*****************