*****************
*               *
*     @         *
*               *
*   +    +      *
*               *
*+       +      *
*               *
*               *
*       +     # *
*****************