*****************
*       +     + *
*+              *
*           #   *
*      +        *
*               *
*             + *
*   @           *
*               *
* +             *
*****************